########################################################  ######
#                                                      #### O  #
#                                                              #
#              ##############################                  #
#              #                            ###           ######
#              #                              ##           #
#            ###                               #           #
#P ###########                                 #      X   ##
####                                           #           #
                                               #############