#######
#     #
# XO  #
#     #
# P   #
#######
